1111111111111111111111111111111111111111
1e10000000000000100000000000100010000001
1010101010110101011111101010001010101101
101011111011010100000010101010000000000m
1010001010111101011110000000110101011101
1010000100000110100000011110110101010101
1011111111111101011111111110110101110101
1010000000000001000000000000000010000001
1011011010101010001010101010111010101101
1010001000100000000010000010101000101101
1000111111111111111011111110101110111101
1000000000000011000000100000100000000001
1010101010101010101010101010101010101010
0101010101010101010101010101010101010101
1111111111111111111111111111111111111111
