1111111
1e10001
1110111
1000001
100m001
1111111
